0100000000111100000000001
0010011111000111000001101
0010011111000111000001101
0010011111000111000001101
0010011111000111000001101
0010011111000111000001101
0010011111000111000001101
0010011111000111000001101
0010011111000111000001101
0000000000000000000000001
0010011111000111000001101
0010011111000111000001101
0010011111000111000001101
0010011111000111000001101
0010011111020111000001101
0010011111000111000001101
0010011111000111000001101
0010011111000111000001101
0010011111000111000001101
0010011111000111000001101
0010011111000111000001101
0010011111000111000001101
0010011111000111000001101
0010211111000111000001101
0010011111000111000001101
0010011111000111000001101
0010011111000111000001101
0010011111000111000001101
0010011111000111000001101
0010011111000111000001101
0010011111000111000001101
0010011111000111000001101
0010011111000111000001101
0010011111000111000001101
0010011111000111000001101
0010011111000111000001101
0010011111000111000001101
0010011111000111000001101
0010011111000111000001101
0010011111000111000001101
0010011111000111000001101
0010011111000111111111101
0010011111000111000001101
0010011111000111000001101
0010011111000111000001101
0012011111000111000001101
0010011111000111000001101
0010011111000111000001101
0010011111000111000001101
0010011111000111000001101
0010011111000111000001101
0010011111000111000001101
0010011111000111000001101
0010011111000111000001101
0010011111000111000001101
0010011111000111000001101
0010011111000111000001101
0010011111000111000001101
0010011111000111000001101
0010011111000111000001101
0010011111000111000001101
0010011111000111000001101
0010011111000111000001101
0010011111000111000001101
0010011111000111000001101
0010011111000111000001101
0010011111000111000001101
0010011111000111000001101
0010011111000111000001101
0010011111000111000001101
0010011111000111000001101
0010011111000111000001101
0010011111000111000001101
0010011111000111000001101
0010011111000111000001101
0010011111000111000001101
0010011111000111000001101
0010011111000111000001101
0010011111000111000001101
0010011111000111000001101
0010011111000111000001101
0010011111000111000001101
0010011111000111000001101
0010011111000111000001101
0010011111000111000001101
0010011111000111000001101
0010011111000111000001101
0010011111000111000001101
0010011111000111000001101
0010011111000111000001101
0010011111000111000001101
0010011111000111000001101
0010011111000111000001101
0010011111000111000001101
0010011111000111000001101
0010011111000111000001101
0010011111000111000001101
0010011111000111000001101
0010011111000111000001101
0010011111000111000001101
0010011111000111000001101
0010011111000111000001101
0010011111000111000001101
0010011111000111000001101
0010011111000111000001101
0010011111000111000001101
0010011111000111000001101
0010011111000111000001101
0010011111000111000001101
0010011111000111000001101
0010011111000111000001101
0010011111000111000001101
0010011111000111000001101
0010011111000111000001101
0010011111000111000001101
0010011111000111000001101
0010011111000111000001101
0010011111000111000001101
0010011111000111000001101
0010011111000111000001101
0010011111000111000001101
0010011111000111000001101
0010011111000111000001101
0010011111000111000001101
0010011111000111000001101
0010011111000111000001101
0010011111000111000001101
0010011111000111000001101
0010011111000111000001101
0010011111000111000001101
0010011111000111000001101
0010011111000111000001101
0010011111000111000001101
0010011111000111000001101
0010011111000111000001101
0010011111000111000001101
0010011111000111000001101
0010011111000111000001101
0010011111000111000001101
0010011111000111000001101
0010011111000111000001101
0010011111000111000001101
0010011111000111000001101
0010011111000111000001101
0010011111000111000001101
0010011111000111000001101
0010011111000111000001101
0010011111000111000001101
0010011111000111000001101
2012011111000111000001101
0010011111000111000001101
0010011111000111000001101
0010011111000111000001101
0010011111000111000001101
0010011111000111000001101
0010011111000111000001101
0010011111020111000001101
0010011111000111000001101
0010011111000111000001101
