010000000011110000000000
001001111100011100000110
001001111100011100000110
001001111100011100000110
001001111100011100000110
001001111100011100000110
001001111100011100000110
001001111100011100000110
001001111100011100000110
000000000000000000000000
001001111100011100000110
001001111100011100000110
001001111100011100000110
001001111100011100000110
001001111100011100000110
001001111100011100000110
001001111100011100000110
001001111100011100000110
001001111100011100000110
001001111100011100000110
001001111100011100000110
001001111100011100000110
001001111100011100000110
001001111100011100000110
001001111100011100000110
001001111100011100000110
001001111100011100000110
001001111100011100000110
001001111100011100000110
001001111100011100000110
001001111100011100000110
001001111100011100000110
001001111100011100000110
001001111100011100000110
001001111100011100000110
001001111100011100000110
001001111100011100000110
001001111100011100000110
001001111100011100000110
001001111100011100000110
001001111100011100000110
001001111100011100000110
001001111100011100000110
001001111100011100000110
001001111100011100000110
001201111100011100000110
001001111100011100000110